1111111111111
10010000000C1
0P00011111011
100011E000001
1111111111111